##############################################################################################################################################
#                                                                                                                                            #
#                                                                                                                                            #
#                                                                                                                                            #
#                                                                                                                                            #
#                                                                                                                                            #
#                                                                                                                                            #
#                                                                                                                                            #
#                                                                                                                                            #
#                                                                                                                                            #
#                                                                                                                                            #
#                                                                                                                                            #
#                                                                                                                                            #
#                                                                                                                                            #
#                                                                                                                                            #
#                                                                                                                                            #
#                                                                                                                                            #
#                                                                                                                                            #
#                                                                                                                                            #
#                                                                                                                                            #
#                                                                                                                                            #
#                                                                                                                                            #
#                                                                                                                                            #
#                                                                                                                                            #
#                                                                                                                                            #
#                                                                                                                                            #
#                                                                                                                                            #
#                                                                                                                                            #
#                                                                                                                                            #
#                                                                                                                                            #
#                                                                                                                                            #
#                                                                                                                                            #
#                                                                                                                                            #
#                                                                                                                                            #
#                                                                                                                                            #
#                                                                                                                                            #
#                                                                                                                                            #
#                                                                                                                                            #
#                                                                                                                                            #
#                                                                                                                                            #
#                                                                                                                                            #
#                                                                                                                                            #
#                                                                                                                                            #
#                                                                                                                                            #
#                                                                                                                                            #
#                                                                                                                                            #
##############################################################################################################################################